Strategix Map v.0.1
Maps/terrains.def
Little

10 10
10 10 10 10 10 10 10 10 10 10 
10 10 10 10 10 10 10 10 10 10 
10 10 10 10 10 10 10 10 10 10 
10 10 10 10 10 10 10 10 10 10 
10 10 10 10 10 10 10 4 4 4 
10 10 10 10 10 10 4 4 4 4 
10 10 10 10 10 4 4 4 4 4 
10 10 10 10 4 4 4 4 13 13 
10 10 10 10 4 4 4 13 13 13 
10 10 10 4 4 4 13 13 13 13 

1
2 2

6
3 0 1
4 0 1
0 4 1
9 4 1
1 5 1
9 5 1
