Strategix Map
0.0.1

8
0 none 0
1 dirt 0.6
2 rock 0.8
3 water 0
4 sand 0.5
5 rubble 1.5
6 grass 1
7 swamp 0.3

40 25
 6  6  6  6  6  6  6  6  6  6  6  6  6  6  6  6  6  6  6  6  6  6  6  6  1  1  1  1  1  1  1  1  1  1  1  1  1  1  1  1 
 6  6  6  6  6  6  6  6  6  6  6  6  6  6  6  6  6  6  6  6  6  6  6  6  1  1  1  1  1  1  1  1  1  1  1  1  1  1  1  1 
 6  6  6  6  6  6  6  6  6  6  6  6  6  6  6  6  6  6  6  6  6  6  6  6  1  1  1  1  1  1  1  1  1  1  1  1  1  1  1  1 
 6  6  6  6  6  6  6  6  6  6  6  6  6  6  6  6  6  6  6  6  6  6  6  6  6  1  1  1  1  1  1  1  1  1  1  1  1  1  1  1 
 6  6  6  6  6  6  6  6  6  6  6  6  6  6  6  6  6  6  6  6  6  6  6  6  6  1  1  1  1  1  1  1  1  1  1  1  1  1  1  1 
 6  6  6  6  6  6  6  6  6  6  6  6  6  6  6  6  6  6  5  5  5  5  5  6  6  6  1  1  1  1  1  1  1  1  1  1  1  1  1  1 
 6  6  6  6  6  6  6  6  6  6  6  6  6  5  5  5  5  5  5  6  6  6  5  5  5  5  1  1  1  1  1  1  1  1  1  1  1  1  1  1 
 6  6  6  6  6  6  6  6  6  6  6  6  5  5  6  6  6  6  6  6  6  6  6  6  6  5  5  1  1  1  1  1  1  1  1  1  1  1  1  1 
 6  6  6  6  6  6  6  6  6  6  6  5  5  6  6  6  6  6  6  3  3  3  3  3  6  6  5  5  1  1  1  1  1  1  1  1  1  1  1  1 
 6  6  6  6  6  6  6  6  6  6  5  5  6  6  6  6  6  3  3  3  3  3  3  3  3  6  6  5  5  1  1  1  1  1  1  1  1  1  1  1 
 6  6  6  6  6  6  6  6  6  5  5  6  6  6  6  6  3  3  3  3  3  3  3  3  3  3  6  6  5  6  6  6  1  1  1  1  1  1  1  1 
 6  6  6  6  6  6  6  6  6  5  6  6  6  6  3  3  3  3  3  3  3  3  3  3  3  3  6  6  5  6  6  6  6  6  6  1  1  1  1  1 
 6  6  6  6  6  6  6  6  6  5  6  6  6  3  3  3  3  6  6  6  3  3  3  3  3  3  6  6  5  6  6  6  6  6  6  6  6  6  6  6 
 6  6  6  6  6  6  6  6  6  5  6  6  6  3  3  3  6  6  6  6  6  3  3  3  3  6  6  6  5  6  6  6  6  6  6  6  6  6  6  6 
 6  6  6  6  6  6  6  6  6  5  6  6  3  3  3  3  6  6  6  6  6  3  3  3  3  6  6  6  5  6  6  6  6  6  6  6  6  6  6  6 
 6  6  6  6  6  6  6  6  6  5  6  6  3  3  3  3  3  6  6  6  3  3  3  3  3  6  6  6  5  6  6  6  6  6  6  6  6  6  6  6 
 6  4  4  4  4  6  6  6  6  5  6  6  3  3  3  3  3  3  3  3  3  3  3  3  6  6  6  5  5  6  6  6  6  6  6  6  6  6  6  6 
 4  4  4  4  4  4  4  4  6  5  6  6  3  3  3  3  3  3  3  3  3  3  3  6  6  6  5  5  6  6  6  6  6  6  6  6  6  6  6  6 
 4  4  4  4  4  4  4  4  4  5  6  6  3  3  3  3  3  3  3  3  3  3  6  6  6  5  5  6  6  6  6  6  6  6  6  6  6  6  6  6 
 4  4  4  4  4  4  4  4  4  5  5  6  6  3  3  3  3  3  3  3  6  6  6  6  5  5  6  6  6  6  6  6  6  6  6  6  6  6  6  6 
 4  4  4  4  4  4  4  4  4  4  5  5  6  6  6  6  3  3  6  6  6  6  5  5  5  6  6  6  6  6  6  6  6  6  6  6  6  6  6  6 
 4  4  4  4  4  4  4  4  4  4  4  5  5  6  6  6  6  6  6  6  6  5  5  6  6  6  6  6  6  6  6  6  6  6  6  6  6  6  6  6 
 4  4  4  4  4  4  4  4  4  4  4  4  5  5  5  6  6  6  6  5  5  5  6  6  6  6  6  6  6  6  6  6  6  6  6  6  6  6  6  6 
 4  4  4  4  4  4  4  4  4  4  4  4  4  4  5  5  5  5  5  5  6  6  6  6  6  6  6  6  6  6  6  6  6  6  6  6  6  6  6  6 
 4  4  4  4  4  4  4  4  4  4  4  4  4  4  4  4  6  6  6  6  6  6  6  6  6  6  6  6  6  6  6  6  6  6  6  6  6  6  6  6 

6
3 5 az_base 1
5 6 az_worker 1
2 8 az_worker 1
34 18 az_worker 3
30 19 az_worker 3
33 20 az_base 3

140
17 0 tree 1000
18 0 tree 1000
19 0 tree 1000
20 0 tree 1000
21 0 tree 1000
22 0 tree 1000
23 0 tree 1000
24 0 tree 1000
25 0 tree 1000
15 1 tree 1000
16 1 tree 1000
17 1 tree 1000
18 1 tree 1000
19 1 tree 1000
20 1 tree 1000
21 1 tree 1000
22 1 tree 1000
23 1 tree 1000
24 1 tree 1000
25 1 tree 1000
26 1 tree 1000
5 2 gold 1000
6 2 gold 1000
15 2 tree 1000
16 2 tree 1000
18 2 tree 1000
19 2 tree 1000
20 2 tree 1000
21 2 tree 1000
22 2 tree 1000
23 2 tree 1000
24 2 tree 1000
25 2 tree 1000
26 2 tree 1000
4 3 gold 1000
7 3 gold 1000
8 3 gold 1000
14 3 tree 1000
15 3 tree 1000
23 3 tree 1000
24 3 tree 1000
25 3 tree 1000
26 3 tree 1000
27 3 tree 1000
31 3 gold 1000
32 3 gold 1000
33 3 gold 1000
8 4 gold 1000
14 4 tree 1000
15 4 tree 1000
34 4 gold 1000
35 4 gold 1000
35 5 gold 1000
33 6 gold 1000
34 6 gold 1000
35 6 gold 1000
1 11 tree 1000
30 11 tree 1000
31 11 tree 1000
0 12 tree 1000
1 12 tree 1000
2 12 tree 1000
3 12 tree 1000
19 12 tree 1000
30 12 tree 1000
31 12 tree 1000
32 12 tree 1000
33 12 tree 1000
34 12 tree 1000
0 13 tree 1000
1 13 tree 1000
2 13 tree 1000
3 13 tree 1000
4 13 tree 1000
5 13 tree 1000
6 13 tree 1000
17 13 gold 1000
18 13 gold 1000
32 13 tree 1000
33 13 tree 1000
34 13 tree 1000
35 13 tree 1000
36 13 tree 1000
37 13 tree 1000
0 14 tree 1000
4 14 tree 1000
5 14 tree 1000
6 14 tree 1000
7 14 tree 1000
8 14 tree 1000
16 14 tree 1000
18 14 gold 1000
19 14 gold 1000
34 14 tree 1000
35 14 tree 1000
36 14 tree 1000
37 14 tree 1000
6 15 tree 1000
7 15 tree 1000
8 15 tree 1000
19 15 tree 1000
35 15 tree 1000
36 15 tree 1000
37 15 tree 1000
38 15 tree 1000
39 15 tree 1000
36 16 tree 1000
37 16 tree 1000
38 16 tree 1000
39 16 tree 1000
37 17 tree 1000
38 17 tree 1000
39 17 tree 1000
2 20 gold 1000
3 20 gold 1000
4 20 gold 1000
3 21 gold 1000
3 22 gold 1000
4 22 gold 1000
29 22 gold 1000
32 22 gold 1000
4 23 gold 1000
5 23 gold 1000
6 23 gold 1000
12 23 tree 1000
21 23 tree 1000
22 23 tree 1000
29 23 gold 1000
30 23 gold 1000
31 23 gold 1000
33 23 gold 1000
12 24 tree 1000
13 24 tree 1000
14 24 tree 1000
15 24 tree 1000
19 24 tree 1000
20 24 tree 1000
21 24 tree 1000
22 24 tree 1000
23 24 tree 1000
