Strategix Map v.0.1
Maps/terrains.def
First Conflict

25 20
0 1 2 3 4 5 6 7 8 9 10 11 0 0 0 1 0 0 4 5 6 7 8 9 10 
1 2 8 8 8 6 7 8 9 10 11 0 0 0 0 0 0 0 0 0 7 8 9 10 11 
8 8 8 8 8 8 8 9 10 11 12 0 0 1 0 0 0 0 0 0 0 9 10 11 12 
8 8 8 8 8 8 8 8 8 8 8 8 1 2 0 0 0 0 0 0 0 0 11 0 0 
8 8 8 8 8 8 8 8 8 8 8 13 13 13 13 0 0 0 0 0 0 0 0 0 0 
8 8 8 8 8 8 8 8 8 8 13 13 13 13 13 13 0 0 0 0 0 0 0 0 1 
8 8 8 8 8 8 8 8 8 8 13 13 13 13 13 13 13 13 0 0 8 8 0 1 2 
7 8 8 8 8 8 8 8 8 13 13 13 13 13 13 13 13 13 13 8 8 8 8 2 3 
8 8 8 8 8 8 8 8 8 13 13 13 13 13 13 13 13 13 13 8 8 8 8 8 4 
9 10 8 8 8 8 8 8 13 13 13 13 13 13 13 13 13 13 8 8 8 8 8 8 5 
10 11 0 0 8 8 8 8 13 13 13 13 13 13 13 13 13 13 8 8 8 8 8 8 6 
11 0 0 0 1 2 3 13 13 13 13 13 13 13 13 13 13 8 8 8 8 8 8 8 7 
0 0 0 1 2 3 4 13 13 13 13 13 13 13 13 13 8 8 8 8 8 8 8 8 8 
0 0 1 2 3 4 0 0 0 13 13 13 13 13 13 8 8 8 8 8 8 8 8 8 9 
0 1 0 0 0 0 0 0 0 0 13 13 13 13 8 8 8 8 8 8 8 8 8 8 10 
1 2 0 0 0 0 0 0 0 0 13 12 13 0 8 8 8 8 8 8 8 8 8 10 11 
2 3 0 0 0 0 0 0 0 0 0 0 0 1 8 8 8 8 8 8 8 8 8 11 12 
3 4 5 0 0 0 0 0 0 0 0 0 1 2 3 8 8 8 8 8 8 10 11 12 0 
4 5 6 0 0 0 0 0 0 0 0 0 2 3 4 5 6 7 8 9 10 11 0 0 0 
5 6 7 8 0 0 0 0 0 0 1 2 3 4 5 6 7 8 9 10 11 12 0 0 1 

2
2 3
21 17

2
5 0 gold 100000
22 0 gold 100000
