Strategix Map v.0.1
terrains.def
First Conflict

25 20
0 1 2 3 4 5 6 7 8 9 10 11 0 0 0 1 0 0 4 5 6 7 8 9 10 
1 2 8 8 8 6 7 8 9 10 11 0 0 0 0 0 0 0 0 0 7 8 9 10 11 
8 8 8 8 8 8 8 9 10 11 12 0 0 1 0 0 0 0 0 0 0 9 10 11 12 
8 8 8 8 8 8 8 8 8 8 8 8 1 2 0 0 0 0 0 0 0 0 11 0 0 
8 8 8 8 8 8 8 8 8 8 8 13 13 13 13 0 0 0 0 0 0 0 0 0 0 
8 8 8 8 8 8 8 8 8 8 13 13 13 13 13 13 0 0 0 0 0 0 0 0 1 
8 8 8 8 8 8 8 8 8 8 13 13 13 13 13 13 13 13 0 0 8 8 0 1 2 
7 8 8 8 8 8 8 8 8 13 13 13 13 13 13 13 13 13 13 8 8 8 8 2 3 
8 8 8 8 8 8 8 8 8 13 13 13 13 13 13 13 13 13 13 8 8 8 8 8 4 
9 10 8 8 8 8 8 8 13 13 13 13 13 13 13 13 13 13 8 8 8 8 8 8 5 
10 11 0 0 8 8 8 8 13 13 13 13 13 13 13 13 13 13 8 8 8 8 8 8 6 
11 0 0 0 1 2 3 13 13 13 13 13 13 13 13 13 13 8 8 8 8 8 8 8 7 
0 0 0 1 2 3 4 13 13 13 13 13 13 13 13 13 8 8 8 8 8 8 8 8 8 
0 0 1 2 3 4 0 0 0 13 13 13 13 13 13 8 8 8 8 8 8 8 8 8 9 
0 1 0 0 0 0 0 0 0 0 13 13 13 13 8 8 8 8 8 8 8 8 8 8 10 
1 2 0 0 0 0 0 0 0 0 13 12 13 0 8 8 8 8 8 8 8 8 8 10 11 
2 3 0 0 0 0 0 0 0 0 0 0 0 1 8 8 8 8 8 8 8 8 8 11 12 
3 4 5 0 0 0 0 0 0 0 0 0 1 2 3 8 8 8 8 8 8 10 11 12 0 
4 5 6 0 0 0 0 0 0 0 0 0 2 3 4 5 6 7 8 9 10 11 0 0 0 
5 6 7 8 0 0 0 0 0 0 1 2 3 4 5 6 7 8 9 10 11 12 0 0 1 

2
2 3
21 17

26
5 0 1
22 0 1
23 0 1
24 0 1
5 1 1
22 1 1
23 1 1
24 1 1
22 2 1
23 2 1
24 2 1
0 5 1
0 6 1
23 13 1
24 13 1
0 17 1
1 17 1
2 17 1
0 18 1
1 18 1
2 18 1
17 18 1
0 19 1
1 19 1
2 19 1
18 19 1
