Strategix Map
0.0.1

30 20
10 10 10 10 10 10 10 10 10 10 10 10 10 10 10 10 10 10 10 10 10 10 10 10 10 10 10 10 10 10 
10 10 10 10 10 10 10 10 10 10 10 10 10 10 10 10 10 10 10 10 10 10 10 10 10 10 10 10 10 10 
10 10 10 10 10 10 10 10 10 10 10 10 10 10 10 10 10 10 10 10 10 10 10 10 10 10 10 10 10 10 
10 10 10 10 10 10 10 10 10 10 10 10 10 10 10 10 13 13 10 10 10 10 10 10 10 10 10 10 10 10 
10 10 10 10 10 10 10 10 10 10 10 10 10 13 13 13 13 13 10 10 10 10 10 10 10 10 10 10 10 10 
10 10 10 10 10 10 10 10 10 10 10 10 10 13 13 13 13 13 13 10 10 10 10 10 10 10 10 10 10 10 
10 10 10 10 10 10 10 10 10 10 10 10 13 13 13 13 13 13 13 10 10 10 10 10 10 10 10 10 10 10 
10 10 10 10 10 10 10 10 10 10 10 10 13 13 13 13 13 13 13 13 10 10 10 10 10 10 10 10 10 10 
10 10 10 10 10 10 10 10 10 10 10 13 13 13 13 13 13 13 13 13 10 10 10 10 10 10 10 10 10 10 
10 10 10 10 10 10 10 10 10 10 13 13 13 13 13 13 13 13 13 13 10 10 10 10 10 10 10 10 10 10 
10 10 10 10 10 10 10 10 10 10 13 13 10 10 10 13 13 13 13 13 10 10 10 10 10 10 10 10 10 10 
10 10 10 10 10 10 10 10 10 10 13 13 10 10 10 13 13 13 13 13 13 10 10 10 10 10 10 10 10 10 
10 10 10 10 10 10 10 10 10 10 13 13 10 10 10 13 13 13 13 13 13 10 10 10 10 10 10 10 10 10 
10 10 10 10 10 10 10 10 10 10 10 13 13 13 13 13 13 13 13 13 13 10 10 10 10 10 10 10 10 10 
10 10 10 10 10 10 10 10 10 10 10 13 13 13 13 13 13 13 13 13 13 10 10 10 10 10 10 10 10 10 
10 10 10 10 10 10 10 10 10 10 10 10 10 13 13 13 13 13 13 13 13 10 10 10 10 10 10 10 10 10 
10 10 10 10 10 10 10 10 10 10 10 10 10 13 13 13 13 13 13 13 13 10 10 10 10 10 10 10 10 10 
10 10 10 10 10 10 10 10 10 10 10 10 10 10 10 10 13 13 13 13 10 10 10 10 10 10 10 10 10 10 
10 10 10 10 10 10 10 10 10 10 10 10 10 10 10 10 10 10 10 10 10 10 10 10 10 10 10 10 10 10 
10 10 10 10 10 10 10 10 10 10 10 10 10 10 10 10 10 10 10 10 10 10 10 10 10 10 10 10 10 10 

2
13 water -1.0
10 grass1 1.0

2
3 10
26 11

11
3 2 gold 100000
4 2 gold 100000
26 2 gold 100000
27 3 gold 100000
28 3 gold 100000
13 11 gold 100000
1 15 gold 100000
2 16 gold 100000
3 16 gold 100000
26 17 gold 100000
27 17 gold 100000
