Strategix Map v.0.1
terrains.def
NewMap

24 27
10 10 10 10 10 10 10 10 10 10 10 10 10 10 10 10 10 10 10 10 10 10 10 10 
10 10 10 10 1 1 1 1 1 1 10 10 10 10 10 10 10 10 10 10 10 10 10 10 
10 10 10 10 1 1 1 1 1 1 1 1 1 1 10 10 10 10 10 10 10 10 10 10 
10 10 1 1 1 1 2 2 2 2 1 1 10 1 1 1 10 10 10 10 10 10 10 10 
10 10 1 2 2 2 2 2 2 2 2 1 1 1 10 1 10 10 10 10 10 10 10 10 
10 10 1 2 2 2 2 2 2 2 2 1 1 1 1 1 10 10 10 10 10 10 10 10 
10 1 1 2 2 2 2 2 2 2 2 10 10 10 10 1 1 10 10 10 10 10 10 10 
10 10 1 1 2 2 2 2 2 2 2 10 10 10 10 10 1 1 10 10 10 10 10 10 
10 10 10 1 2 2 2 2 2 1 1 10 10 10 10 10 10 1 10 10 10 10 10 10 
10 10 10 1 1 1 1 1 1 1 1 10 13 13 13 10 10 1 10 10 10 10 10 10 
10 10 10 1 1 1 1 10 10 10 10 13 13 13 13 13 10 1 1 10 10 10 10 10 
10 10 10 10 1 1 1 1 10 10 10 13 13 13 13 10 10 1 1 10 10 10 10 13 
10 10 10 10 10 1 1 1 10 10 10 13 13 13 10 10 10 1 10 10 10 10 10 13 
10 10 10 10 10 10 1 1 10 10 10 10 10 10 10 10 1 1 10 10 10 10 10 13 
10 10 10 10 10 10 10 1 1 1 10 10 10 10 10 1 1 10 10 10 10 10 13 13 
10 10 10 10 10 10 10 10 10 1 1 1 1 1 1 1 10 10 10 10 10 13 13 13 
10 10 10 10 10 10 10 10 10 10 10 10 10 10 10 10 10 10 10 10 13 13 13 13 
10 10 10 10 10 10 10 10 10 10 10 10 10 10 10 10 10 10 13 13 13 13 13 13 
10 10 10 10 10 10 10 10 10 10 10 10 10 10 10 10 13 13 13 13 13 13 13 10 
10 10 10 10 10 10 13 13 13 10 10 10 10 13 13 13 13 13 13 13 13 13 13 10 
10 10 10 10 10 10 10 13 13 13 13 13 13 13 13 13 13 13 13 13 13 13 10 10 
10 10 10 10 10 10 10 10 10 13 13 13 13 13 13 13 13 13 13 13 13 10 10 10 
10 10 10 10 10 10 10 10 10 10 13 13 13 13 13 13 13 13 13 13 10 10 10 10 
10 10 10 10 10 10 10 10 10 10 10 10 13 13 13 13 13 13 10 10 10 10 10 10 
10 10 10 10 10 10 10 10 10 10 10 10 10 10 10 10 10 10 10 10 10 10 10 10 
10 10 10 10 10 10 10 10 10 10 10 10 10 10 10 10 10 10 10 10 10 10 10 10 
10 10 10 10 10 10 10 10 10 10 10 10 10 10 10 10 10 10 10 10 10 10 10 10 

0

0
