6

1	grass		1.0
2	rubble		1.5
3	water		-1.0
4	swamp		0.3
5	lava		0.7
6	sand		0.5

16 12

2 2 2 2 4 4 4 4 4 4 2 2 2 2 3 3
2 2 2 2 2 4 4 4 4 4 4 2 2 2 3 3
1 1 2 2 1 1 1 4 4 4 4 4 2 2 3 3
1 1 1 1 1 1 1 4 3 3 4 4 4 4 3 3
1 1 1 1 2 2 2 4 3 3 4 4 4 4 3 3
1 5 3 3 3 3 2 2 3 3 5 5 5 3 3 3
5 5 3 3 3 3 3 2 2 3 5 5 5 3 1 1
5 5 3 5 4 3 3 2 2 2 5 5 5 1 1 1
5 5 3 4 4 3 3 3 2 2 2 5 3 3 1 1
4 4 3 4 4 4 3 3 2 2 2 3 3 3 3 3
1 1 3 1 1 1 3 1 1 1 1 1 3 3 1 1
1 1 1 1 2 2 2 2 2 2 2 1 1 3 1 1

2

2 2
12 11