Strategix Map v.0.1
Maps/terrains.def
N

10 10
10 10 10 10 10 10 10 10 10 10 
10 10 10 10 10 10 10 10 10 10 
10 10 10 13 13 13 10 10 10 10 
10 10 13 13 13 13 13 10 10 10 
10 10 13 13 13 13 13 10 10 10 
10 10 13 13 13 13 13 10 10 10 
10 10 13 13 13 13 13 10 10 10 
10 10 13 13 13 13 13 10 10 10 
10 10 10 10 10 10 10 10 10 10 
10 10 10 10 10 10 10 10 10 10 

0

0
