Strategix Map
0.0.1

3
3 water 0
6 grass 1
5 rubble 1.5

40 25
 6  6  6  6  6  6  6  6  6  6  6  6  6  6  6  6  6  6  6  6  6  6  6  6  6  6  6  6  6  6  6  6  6  6  6  6  6  6  6  6 
 6  6  6  6  6  6  6  6  6  6  6  6  6  6  6  6  6  6  6  6  6  6  6  6  6  6  6  6  6  6  6  6  6  6  6  6  6  6  6  6 
 6  6  6  6  6  6  6  6  6  6  6  6  6  6  6  6  6  6  6  6  6  6  6  6  6  6  6  6  6  6  6  6  6  6  6  6  6  6  6  6 
 6  6  6  6  6  6  6  6  6  6  6  6  6  6  6  6  6  6  6  6  6  6  6  6  6  6  6  6  6  6  6  6  6  6  6  6  6  6  6  6 
 6  6  6  6  6  6  6  6  6  6  6  6  6  6  6  6  6  6  6  6  6  6  6  6  6  6  6  6  6  6  6  6  6  6  6  6  6  6  6  6 
 6  6  6  5  5  5  5  5  6  6  6  6  6  6  6  6  6  6  6  6  6  6  6  6  6  6  6  6  6  6  6  6  6  6  6  6  6  6  6  6 
 6  6  6  5  5  5  5  5  5  6  6  6  6  6  6  6  6  6  6  6  6  6  6  6  6  6  6  6  6  6  6  6  6  6  6  6  6  6  6  6 
 6  6  6  5  5  5  5  5  5  6  6  6  6  6  6  6  6  6  6  6  6  6  6  6  6  6  6  6  6  6  6  6  6  6  6  6  6  6  6  6 
 6  6  6  6  5  5  5  5  5  6  6  6  6  6  6  6  6  6  6  3  3  3  3  3  6  6  6  6  6  6  6  6  6  6  6  6  6  6  6  6 
 6  6  6  6  6  6  6  6  6  6  6  6  6  6  6  6  6  3  3  3  3  3  3  3  3  6  6  6  6  6  6  6  6  6  6  6  6  6  6  6 
 6  6  6  6  6  6  6  6  6  6  6  6  6  6  6  6  3  3  3  3  3  3  3  3  3  3  6  6  6  6  6  6  6  6  6  6  6  6  6  6 
 6  6  6  6  6  6  6  6  6  6  6  6  6  6  3  3  3  3  3  3  3  3  3  3  3  3  6  6  6  6  6  6  6  6  6  6  6  6  6  6 
 6  6  6  6  6  6  6  6  6  6  6  6  6  3  3  3  3  6  6  6  3  3  3  3  3  3  6  6  6  6  6  6  6  6  6  6  6  6  6  6 
 6  6  6  6  6  6  6  6  6  6  6  6  6  3  3  3  6  6  6  6  6  3  3  3  3  6  6  6  6  6  6  6  6  6  6  6  6  6  6  6 
 6  6  6  6  6  6  6  6  6  6  6  6  3  3  3  3  6  6  6  6  6  3  3  3  3  6  6  6  6  6  6  6  6  6  6  6  6  6  6  6 
 6  6  6  6  6  6  6  6  6  6  6  6  3  3  3  3  3  6  6  6  3  3  3  3  3  6  6  6  6  6  6  6  6  6  6  6  6  6  6  6 
 6  6  6  6  6  6  6  6  6  6  6  6  3  3  3  3  3  3  3  3  3  3  3  3  6  6  6  6  6  6  6  6  6  6  6  6  6  6  6  6 
 6  6  6  6  6  6  6  6  6  6  6  6  3  3  3  3  3  3  3  3  3  3  3  6  6  6  6  6  6  6  6  6  6  6  6  6  6  6  6  6 
 6  6  6  6  6  6  6  6  6  6  6  6  3  3  3  3  3  3  3  3  3  3  6  6  6  6  6  6  5  5  5  5  5  6  6  6  6  6  6  6 
 6  6  6  6  6  6  6  6  6  6  6  6  6  3  3  3  3  3  3  3  6  6  6  6  6  6  6  6  5  5  5  5  5  5  6  6  6  6  6  6 
 6  6  6  6  6  6  6  6  6  6  6  6  6  6  6  6  3  3  6  6  6  6  6  6  6  6  6  6  5  5  5  5  5  5  6  6  6  6  6  6 
 6  6  6  6  6  6  6  6  6  6  6  6  6  6  6  6  6  6  6  6  6  6  6  6  6  6  6  6  6  5  5  5  5  5  6  6  6  6  6  6 
 6  6  6  6  6  6  6  6  6  6  6  6  6  6  6  6  6  6  6  6  6  6  6  6  6  6  6  6  6  6  6  6  6  6  6  6  6  6  6  6 
 6  6  6  6  6  6  6  6  6  6  6  6  6  6  6  6  6  6  6  6  6  6  6  6  6  6  6  6  6  6  6  6  6  6  6  6  6  6  6  6 
 6  6  6  6  6  6  6  6  6  6  6  6  6  6  6  6  6  6  6  6  6  6  6  6  6  6  6  6  6  6  6  6  6  6  6  6  6  6  6  6 

2
6 7 az_worker 1
30 19 az_worker 3

141
17 0 tree 100000
18 0 tree 100000
19 0 tree 100000
20 0 tree 100000
21 0 tree 100000
22 0 tree 100000
23 0 tree 100000
24 0 tree 100000
25 0 tree 100000
15 1 tree 100000
16 1 tree 100000
17 1 tree 100000
18 1 tree 100000
19 1 tree 100000
20 1 tree 100000
21 1 tree 100000
22 1 tree 100000
23 1 tree 100000
24 1 tree 100000
25 1 tree 100000
26 1 tree 100000
5 2 gold 1000
6 2 gold 1000
15 2 tree 100000
16 2 tree 100000
18 2 tree 100000
19 2 tree 100000
20 2 tree 100000
21 2 tree 100000
22 2 tree 100000
23 2 tree 100000
24 2 tree 100000
25 2 tree 100000
26 2 tree 100000
4 3 gold 1000
7 3 gold 1000
8 3 gold 1000
14 3 tree 100000
15 3 tree 100000
23 3 tree 100000
24 3 tree 100000
25 3 tree 100000
26 3 tree 100000
27 3 tree 100000
31 3 gold 100000
32 3 gold 100000
33 3 gold 100000
8 4 gold 1000
14 4 tree 100000
15 4 tree 100000
34 4 gold 100000
35 4 gold 100000
35 5 gold 100000
33 6 gold 100000
34 6 gold 100000
35 6 gold 100000
1 11 tree 100000
2 11 tree 100000
30 11 tree 100000
31 11 tree 100000
0 12 tree 100000
1 12 tree 100000
2 12 tree 100000
3 12 tree 100000
19 12 tree 100000
30 12 tree 100000
31 12 tree 100000
32 12 tree 100000
33 12 tree 100000
34 12 tree 100000
0 13 tree 100000
1 13 tree 100000
2 13 tree 100000
3 13 tree 100000
4 13 tree 100000
5 13 tree 100000
6 13 tree 100000
17 13 gold 100000
18 13 gold 100000
32 13 tree 100000
33 13 tree 100000
34 13 tree 100000
35 13 tree 100000
36 13 tree 100000
37 13 tree 100000
0 14 tree 100000
4 14 tree 100000
5 14 tree 100000
6 14 tree 100000
7 14 tree 100000
8 14 tree 100000
16 14 tree 100000
18 14 gold 100000
19 14 gold 100000
34 14 tree 100000
35 14 tree 100000
36 14 tree 100000
37 14 tree 100000
6 15 tree 100000
7 15 tree 100000
8 15 tree 100000
19 15 tree 100000
35 15 tree 100000
36 15 tree 100000
37 15 tree 100000
38 15 tree 100000
39 15 tree 100000
36 16 tree 100000
37 16 tree 100000
38 16 tree 100000
39 16 tree 100000
37 17 tree 100000
38 17 tree 100000
39 17 tree 100000
2 20 gold 100000
3 20 gold 100000
4 20 gold 100000
3 21 gold 100000
3 22 gold 100000
4 22 gold 100000
29 22 gold 100000
32 22 gold 1000
4 23 gold 100000
5 23 gold 100000
6 23 gold 100000
12 23 tree 100000
21 23 tree 100000
22 23 tree 100000
29 23 gold 100000
30 23 gold 100000
31 23 gold 1000
33 23 gold 1000
12 24 tree 100000
13 24 tree 100000
14 24 tree 100000
15 24 tree 100000
19 24 tree 100000
20 24 tree 100000
21 24 tree 100000
22 24 tree 100000
23 24 tree 100000
